00000000000000000000
00001100000000111100
00001000000001100100
00001111000001001100
00000001000011101000
00000011111110100000
00111020000000100000
00101010000000200000
01101011110121101110
00001110010100001010
00000000010111111010
00001110010000000010
00002011110010001210
00001000100010001000
00001000111110111011
00001001100000101210
11111001010001100000
00100001110001000000
00111100000001100000
00000000000000000000
