00000000000000000000
00000111110010000110
00000100010010000100
00100111000011111100
00100001000000001000
00100011211000121100
01100010001110100100
01011110011010110111
01110001010010010000
00010001110000011000
00011100011211001000
00000100000001002000
00111101100111001000
00100000100200001000
00200000111100001110
00111000000100001010
11101000100111121010
00001000100000000010
00001111100000000110
00000000000000000000
