00000000000000000000
01000011100001111100
01000000100001000100
01101121111001000100
00111000001110001110
00001111001011001010
00000001011000111010
00000001010000001010
01121001012110001110
01001001000010001000
11001002011110011100
00011001010020010110
00010001000110010020
00011111000100011010
00000010110100010011
00011010010111110000
00010010010001000000
00011110011111000000
00000000000000000000
00000000000000000000
